7 13
 # # ###  #B#
 # #   # ## #
   # #   ## #
# ## # #### #
#    # ####  
### ## ##### 
A   ##       